 
 
 
 
 
 
 
 
 
 
 
 
 
 
 
 
                c
          GLt  GL                      f
t         MNKHKNR                  t  GL
GL        MNOPQOR  G              GHKHOR
MNL       MNOPQNR  MHKL           MOPQOR
MNRt      MOQPNQR  MNOQHL        GNQPONR
MNOKL     MQONQPR   SOPQO      GKOQNQOPR
STUVWL    SVUTWVX    VUWUKL  GHWTVUWUVTX

